############
#..........#
#...GG.....#
#...BB.....#
#....P.....#
#..........#
#..........#
#..........#
#..........#
############
