############
#..........#
#..........#
#....G.....#
#....B.....#
#....P.....#
#..........#
#..........#
#..........#
############
