############
#..........#
#..###.....#
#..#G#.....#
#..#B#.....#
#..#P#.....#
#..#..GG...#
#..#..BB...#
#..........#
############
